******************************
*                            *
*                            *
*                            *
*                            *
*                            *
*                            *
*                            *
*                            *
*                            *
*                            *
*                            *
*             D              *
*                            *
*                            *
*                            *
*                            *
*                            *
*                            *
******************************
