                ******************************
                ******************************
                *                            *
                *                            *
                *                            *
                *                            *
                *                            *
                *                            *
                *                            *
                *                            *
                *                            *
                *                            *
                *                            *
                *                            *
                *                            *
                *                            *
                *                            *
                *                            *
*****************                            ********************
*                                                               *
*                                                               *
*                                                               *
*                                                               *
*                                                               *
*                                                               *
*                                                               *
*                              D                                *
*                                                               *
*                                                               *
*                                                               *
*                                                               *
*                                                               *
*                                                               *
*                                                               *
*****************                            ********************
                *                            *
                *                            *
                *                            *
                *                            *
                *                            *
                *                            *
                *                            *
                *                            *
                *                            *
                *                            *
                *                            *
                *                            *
                *                            *
                *                            *
                *                            *
                *                            *
                ******************************
