******************************
*                            *
*                            *
*     * * * *                *
*                            *
*                 *          *
*                            *
*               D            *
*          ****              *
*                            *
*                            *
*              *             *
*               *            *
*               *            *
*               *            *
*               *            *
*               *            *
*                *           *
*                            *
******************************
