******************************
******************************
*                            *
*                            *
*                            *
*                            *
*                            *
*                            *
*                            *
*           D                *
*                            *
*                            *
*                            *
*                            *
*                            *
*                            *
*                            *
*                            *
*                            *
******************************
