******************************
*                            *
*                            *
*     *******                *
*                            *
*     ******            *    *
*                            *
*                            *
*          ****              *
*    D                       *
*                            *
*              *             *
*               *            *
*               *            *
*               *            *
*               *            *
*               *            *
*                *           *
*                            *
******************************
