********************************************************************************
*                                                                              *
*                                                                              *
*        *       *         ************                                        *
*        *     *           *          *                                        *
*        *   *             *          *                                        *
*        * *               *          *                                        *
*        *                 ************                                        *
*        *  *              *          *                                        *
*        *    *            *          *                                        *
*        *      *          *          *                                        *
*        *        *        *          *                                        *
*        *          *      *          *                                        *
*                                                                              *
*                                                                              *
*                                                                              *
*                                                                              *
*                                                                              *
*                                                                              *
*                                                                              *
*        *                                                                     *
*        *                              *                                      *
*        *                             *                                       *
*        *                            *                                        *
*        *     *                     *                                         *
*        *     *                    *                                          *
*        *     *                   *                                           *
*        **************           *                                            *
*              *                 *                                             *
*              *                *                                              *
*              *               *                                               *
*              *                                                               *
*              *                                                               *
*                                                                              *
*                                                                              *
*                                                                              *
*                                                                              *
*                                                                              *
*                                                                              *
*                                                                              *
*                                                                              *
*                                                                              *
*                                                                              *
*                                                       ************************
*                                                     *   *                    *
*                                                   *   *                      *
*                                                 *   *                        *
*                                               *   *                          *
*                                             *   *                            *
*                                           *   *                              *
*                                         *   *                                *
*                                       *   *                                  *
*                                     *   *                                    *
*                              ******   *                                      *
*                              *      *                                        *
*********************************** ********************************************
*                                                                              *
*                                                                              *
*                                                                              *
*                                                                              *
*                                                                              *
*                                                                              *
*                                                                              *
*                                                                              *
*                                                                              *
*                                                                              *
*                                                                              *
*                                                                    ***********
*                                                                              *
*                                                                      ******* *
*                                                                      *       *
*                                                                      *       *
*                                                                      *       *
*                                                                      *       *
*                                                                      *       *
*                                                                              *
*                 **           ************************************** ***********
*                **                                                 *          *
*               **                                                  ********** *
*              **                                                   *          *
*              **                                                    *   *******
*                                                                  *           *
*              *******************************                     *********   *
*              *                                                   *           *
*              *                                                   *           *
*              *    *****************                              ****        *
*****************        *               *                                     *
*          *        *     *******   *********************               *      *
*          *        *     *         *                                          *
*    D     **********     *   *******                             *            *
*                         **                                                   *
********************************************************************************
